# Test map for burrow mechanics
# O = Burrow entrance/exit (zapolzanie/vypolzanie), U = Underground path, H = Hill surface, N = entrance tile
##############################################################
#......................^...........^......................#
#.....###.......~~~~~.......###......~~~~........^........#
#....#####......~~~~~......#####.....~~~~.................#
#....#####......~~~~~......#####.....~~~~.................#
#.....###.......~~~~~.......###......~~~~.................#
#................~~~~~.....................^...^..........#
#................~~~~~..................................^..#
#..^.............~~~~~.....................................#
#................~~~~~.....................................#
#................~~~~~.........................^^..........#
#.......^........~~~~~.....................................#
#................~~~~~.....................................#
#................~~~~~.....^.......................^......#
#................~~~~~.....................................#
#....................^......................................#
#.........................................................^.#
#...........................................................#
#...........................................................#
#....................MMM..................................#
#...................MMMMM.................................#
#....................MMM..................................#
#...........................................................#
#.......^.......^.......................................^..#
#...........................................................#
#.......O.......HHHHHHHHHHHHHHHHHHHHHHHH.......O...........#
#.......U.......HHHHHHHHHHHHHHHHHHHHHHHH.......U...........#
#.......U.......HHHHHHHHHHHHHHHHHHHHHHHH.......U...........#
#.......UUUUUUUUHHHHHHHHHHHHHHHHHHHHHHHHUUUUUUUU...........#
#..................................SSSS....................#
#..................................SSSS....................#
#..................................SSSS....................#
#.........................@........SSSS....................#
#..................................SSSS....................#
#..................................SSSS....................#
#..................................SSSS....................#
#...........................................................#
##############################################################
