# CAVE WORLD 62x62
##############################################################
#............................................................#
#...BBBBBB...................................................#
#...B....B...................................................#
#...B....B...................+++++...........................#
#...B....B...................+...+...........................#
#...BBBBBB...................+++++...........................#
#............................................................#
#............................................................#
#............................................................#
#............................................................#
#............................................................#
#...........................BBBBBB...........................#
#...........................B....B...........................#
#...........................B....B...........................#
#...........................B....B...........................#
#...........................BBBBBB...........................#
#............................................................#
#............................................................#
#............................................................#
#............................................................#
#............................................................#
#............................................................#
#............................................................#
#............................................................#
#............................................................#
#..@.........................................................#
#............................................................#
#............................................................#
#............................................................#
#............................................................#
#............................................................#
#............................................................#
#............................................................#
#............................................................#
#............................................................#
#............................................................#
#............................................................#
#............................................................#
#............................................................#
#............................................................#
#............................................................#
#............................................................#
#............................................................#
#............................................................#
#............................................................#
#............................................................#
#............................................................#
#............................................................#
#............................................................#
#............................................................#
#............................................................#
#............................................................#
#............................................................#
#............................................................#
#............................................................#
#............................................................#
#............................................................#
#............................................................#
#............................................................#
#............................................................#
#............................................................#
##############################################################
